+,-,-,+,-,-,+,-,-,+,-,-,+,-,-,+,-,-,+,-,-,+,-,-,+,-,-,+,-,-,+,-,-,+,-,-,+,-,-,+, , ,+,-,-,+,-,-,+
|, , ,|, , ,|, , , , , ,|, , , , , , , , , , , ,|, , , , , ,|, , ,|, , , , , , , , , , , , , , ,|
+, , ,+, , ,+,-,-,+, , ,+, , ,+,-,-,+, , ,+, , ,+, , ,+, , ,+, , ,+, , ,+, , ,+,-,-,+,-,-,+, , ,+
|, , ,|, , , , , ,|, , , , , , , , ,|, , ,|, , , , , ,|, , ,|, , ,|, , ,|, , ,|, , ,|, , , , , ,|
+, , ,+,-,-,+, , ,+, , ,+,-,-,+,-,-,+, , ,+,-,-,+,-,-,+, , ,+, , ,+, , ,+, , ,+, , ,+, , ,+,-,-,+
|, , , , , ,|, , ,|, , , , , ,|, , , , , ,|, , , , , , , , ,|, , , , , ,|, , ,|, , , , , ,|, , ,|
+,-,-,+, , ,+, , ,+,-,-,+,-,-,+, , ,+,-,-,+,-,-,+, , ,+,-,-,+, , ,+,-,-,+, , ,+, , ,+,-,-,+, , ,+
|, , , , , ,|, , , , , ,|, , , , , ,|, , , , , ,|, , , , , ,|, , ,|, , , , , ,|, , , , , , , , ,|
+, , ,+, , ,+,-,-,+, , ,+, , ,+, , ,+, , ,+, , ,+,-,-,+, , ,+,-,-,+, , ,+,-,-,+,-,-,+,-,-,+, , ,+
|, , ,|, , ,|, , , , , ,|, , ,|, , ,|, , ,|, , ,|, , ,|, , , , , , , , ,|, , , , , , , , ,|, , ,|
+, , ,+,-,-,+, , ,+,-,-,+, , ,+,-,-,+, , ,+, , ,+, , ,+,-,-,+,-,-,+,-,-,+, , ,+,-,-,+,-,-,+, , ,+
|, , , , , ,|, , , , , ,|, , ,|, , , , , ,|, , ,|, , , , , , , , , , , , , , , , , ,|, , , , , ,|
+, , ,+, , ,+,-,-,+, , ,+, , ,+, , ,+,-,-,+, , ,+, , ,+,-,-,+,-,-,+,-,-,+,-,-,+, , ,+, , ,+,-,-,+
|, , ,|, , , , , , , , ,|, , , , , , , , ,|, , ,|, , ,|, , , , , , , , ,|, , , , , ,|, , ,|, , ,|
+, , ,+,-,-,+,-,-,+,-,-,+,-,-,+,-,-,+,-,-,+, , ,+, , ,+,-,-,+,-,-,+, , ,+, , ,+,-,-,+, , ,+, , ,+
|, , , , , , , , , , , , , , , , , , , , , , , ,|, , , , , , , , , , , ,|, , , , , , , , , , , ,|
+,-,-,+,-,-,+,-,-,+,-,-,+,-,-,+,-,-,+,-,-,+,-,-,+,-,-,+,-,-,+,-,-,+,-,-,+,-,-,+, , ,+,-,-,+,-,-,+